S 1 9 1 1
1 0 1 0 5
1 0 1 1 1
1 0 9 0 1
1 1 1 0 G
